~~~~~B~~~*~~~~~~~~~~~~~L~~~~~
~~~~~~L****~~~~~~~~~~~~~~~~~~
~~~~~~~~~L********L~~~~~~~~~~
~~~~~~~~~**********~~~LL~~~~~
A~~~~~~~~~~~~~~~~~~~~~~~~~~~~
~~~~~~~~~L********L~~~~~~~~~~
~~~~~~~~~~~~~~~~~~~~~~~~~~~~~
~~~~~~~~~~~~~~~~~~~~~~~L~~~~~