B~~~~~~~~*~~~~~~~~~~~~~L~~~~~
~~~~~~L****~~~~~~~~~~~~~~~~~~
~~~~~~~~~L********L~~~~~~~~~~
~~~~~~~~~**********~~~LL~~~~~
~~~~~~~~~~~~~~~~~~~~~~~~~~~~~
~~~~~~~~~L********L~~~~~~~~~~
~~~~~~~~~~~~~~~~~~~~~~A~~~~~~
~~~~~~~~~~~~~~~~~~~~~~~L~~~~~