~~~~~~~~~*~~~~~~~~~~~~~L~~~~~
~~~~~~L****~~~~~~~~~~~~~~~~~~
~~~~~~~~~L********L~~~~~~~~~~
~~~~~~~~~**********~~~LL~~~~~
A~~~~~~~~~~~~~~~~~~~~~~~~~~~B
~~~~~~~~~L********L~~~~~~~~~~
~~~~~~~~~~~~~~~~~~~~~~~~~~~~~
~~~~~~~~~~~~~~~~~~~~~~~L~~~~~