~~~~~~~~~*~~~~~~~~~~~~~L~~~~~
~~~~~~L****~~~~~~~~~~~~~~~~~~
~~~~~~~~~L********L~~~~~~~~~~
~~~~~~~~~**********~~~~~~~~~~
A~~~~~~~~**********~~~~~~~~~B
~~~~~~~~~L********L~~~~~~~~~~
~~~~~~~~~~~~~~~~~~~~~~~~~~~~~
~~~~~~~~~~~~~~~~~~~~~~~L~~~~~