~~~~~~~~~~~~~~~~~~~~~~~~~~~~~
~~~~~~~~~~~~~~~~~~~~~~~~~~~~~
~~~~~~~~~L********L~~~~~~~~~~
~~~~~~~~~**********~~~~~~~~~~
A~~~~~~~~**********~~~~~~~~~B
~~~~~~~~~L********L~~~~~~~~~~
~~~~~~~~~~~~~~~~~~~~~~~~~~~~~
~~~~~~~~~~~~~~~~~~~~~~~~~~~~~