~~~~~~~~~~~~~~~~~~~~~~~~~~~~~~~~~~~~~~~~~
~~~~~~~~~~~~~~~~~~~~~~~~~~~~~~~~~~~~~~~~~
~~~~~~~~~~~~~~~~~~~~~~~~~~~~~~~~~~~~~~~~~
~~~~~~~~~~~~*L****~~~~~~~~~~~~~~~~~~~~~~~
~~~~~~~~~~~~~****L**~~~~~~~~~~~~~~~~~~~~~
~~~~~~~~~~~~~~~~*****L~~~~~~~~~~~~~~~~~~~
~~~~~~~~~~~~~~~~~~~~***~~~~~~~~~~~~~~~~~~
~~~~~~~~~~~~~~~A~~~**L**~~~~~~~~~~~~~~~~~
~~~~~~~~~~~~~~~~*****~~~~~~~~~~~~~~~~~~~~
~~~~~~~~~~~~~~~**L*~~~~~~B~~~~~~~~~~~~~~~
~~~~~~~~~~~~~~~~~~~~~~~~~~~~~~~~~~~~~~~~~